1 1 1 1 1 1 1 1 1 1
0 0 1 0 0 0 1 0 0 1
1 0 1 0 1 0 1 1 0 1
1 0 0 0 1 0 0 0 0 1
1 1 1 0 1 1 1 0 1 1
1 1 0 0 0 1 0 0 0 1
1 1 1 1 0 0 0 1 0 1
1 0 0 0 0 1 0 1 1 1
1 0 1 1 0 1 0 0 0 1
1 0 1 1 1 1 1 1 1 1

1 0
9 1

;

R DDRR UU R R D D ;
R DDRRD D RDDLLLDD;
DRL RUDDRRDD LLLLL;